WWWWWWWWWWWWWWWWWWWW
.....K..............
.....K..............
.....K..............
....................
....................
.............K......
.............K......
.............K......
WWWWWWWWWWWWWWWWWWWW