WWWWWWWWWWWWWWWWWWWWWWWWWWWWWWWWWWWWWWWW
........................................
........................................
...............BBB......................
...............BBB......................
...............BBB......................
........................................
........................................
........................................
WWWWWWWWWWWWWWWWWWWWWWWWWWWWWWWWWWWWWWWW